##########################################
#........#...............................#
#........#...............................#
#..#..#..#...............................#
#..#..#..#...............................#
#..#..#..#...............................#
#..#.$#..#...............................#
#..####..#...............................#
#........#...............................#
#........#...............................#
#..####..#..#............................#
#..#........#............................#
#..#........#............................#
#..##########............................#
#........................................#
#........................................#
#........................................#
#.....................................#..#
#.....................................#..#
#.....................................#..#
#.................................#####..#
#.................................#$.....#
##########################################